Андромеда: Персей, Кассиопея, Ящерица, Пегас, Рыбы, Треугольник
Близнецы: Рак, Рысь, Возничий, Телец, Орион, Единорог, Малый Пес
Больая Медведица: Волопас, Дракон, Жираф, Рысь, Малый Лев, Лев, Волосы Вероники, Гончие Псы
Большой Пес: Заяц, Голубь, Корма, Единорог
Весы: Скорпион, Змееносец, Змея, Дева, Гидра, Кентавр, Волк
Водолей: Пегас, Малый Конь, Дельфин, Орел, Козерог, Южная Рыба, Скульптор, Кит, Рыбы
Возничий: Рысь, Жираф, Персей, Телец, Близнецы
Волк: Скорпион, Весы, Гидра, Кентавр, Циркуль, Наугольник
Волопас: Северная Корона, Геркулес, Дракон, Большая Медведица, Гончие Псы, Волосы Вероники, Дева, Змея
Волосы Вероники: Волопас, Гончие Псы, Большая Медведица, Лев, Дева
Ворон: Чаша, Гидра, Дева
Геркулес: Дракон, Волопас, Северная Корона, Змея, Змееносец, Орел, Стрела, Лисичка, Лира
Гидра: Секстант, Лев, Рак, Малый Пес, Единорог, Корма, Компас, Насос, Кентавр, Волк, Весы, Дева, Ворон, Чаша
Голубь: Большой Пес, Заяц, Резец, Живописец, Корма
Гончие Псы: Волопас, Большая Медведица, Волосы Вероники
Дева: Весы, Змея, Волопас, Волосы Вероники, Лев, Чаша, Ворон, Гидра
Дельфин: Лисичка, Стрела, Орел, Водолей, Малый Конь, Пегас
Дракон: Лира, Лебедь, Цефей, Малая Медведица, Жираф, Большая Медведица, Волопас, Геркулес
Единорог: Гидра, Малый Пес, Близнецы, Орион, Заяц, Большой Пес, Корма
Жертвенник: Райская Птица, Павлин, Телескоп, Южная Корона, Скорпион, Наугольник, Южный Треугольник
Живописец: Голубь, Резец, Золотая Рыба, Летучая Рыба, Киль, Корма
Жираф: Цефей, Кассиопея, Персей, Возничий, Рысь, Большая Медведица, Дракон, Малая Медведица
Журавль: Микроскоп, Индеец, Тукан, Феникс, Скульптор, Южная Рыба
Заяц: Единорог, Орион, Эридан, Резец, Голубь, Большой Пес
Змееносец: Геркулес, Змея, Весы, Скорпион, Стрелец, Щит, Орел
Змея: Геркулес, Северная Корона, Волопас, Дева, Весы, Змееносец, Стрелец, Щит, Орел
Золотая Рыба: Живописец, Резец, Часы, Сетка, Южная Гидра, Столовая Гора, Летучая Рыба
Индеец: Павлин, Октан, Тукан, Журавль, Микроскоп, Стрелец, Телескоп, 
Кассиопея: Персей, Жираф, Цефей, Ящерица, Андромеда
Кентавр: Волк, Весы, Гидра, Насос, Паруса, Киль, Муха, Южный Крест, Циркуль
Киль: Кентавр, Паруса, Корма, Живописец, Летучая Рыба, Хамелеон, Муха
Кит: Телец, Овен, Рыбы, Водолей, Скульптор, Печь, Эридан
Козерог: Водолей, Орел, Стрелец, Микроскоп, Южная Рыба
Компас: Насос, Гидра, Корма, Паруса
Корма: Киль, Паруса, Компас, Гидра, Единорог, Большой Пес, Голубь, Живописец
Лебедь: Лира, Лисичка, Пегас, Ящерица, Цефей, Дракон
Лев: Гидра, Секстант, Чаша, Дева, Волосы Вероники, Большая Медведица, Малый Лев, Рысь, Рак
Летучая Рыба: Киль, Живописец, Золотая Рыба, Столовая Гора, Хамелеон
Лира: Лебедь, Дракон, Лисичка, Геркулес
Лисичка: Лебедь, Лира, Геркулес, Стрела, Дельфин, Пегас
Малая Медведица: Дракон, Цефей, Жираф
Малый Конь: Дельфин, Водолей, Пегас
Малый Лев: Лев, Большая Медведица, Рысь, Рак
Малый Пес: Гидра, Рак, Близнецы, Единорог
Микроскоп: Телескоп, Индеец, Журавль, Южная Рыба, Козерог, Стрелец
Муха: Киль, Хамелеон, Райская Птица, Циркуль, Кентавр, Южный Крест
Насос: Кентавр, Гидра, Компас, Паруса
Наугольник: Скорпион, Волк, Циркуль, Южный Треугольник, Жертвенник
Овен: Персей, Треугольник, Рыбы, Кит, Телец
Октан: Южная Гидра, Тукан, Индеец, Павлин, Райская Птица, Хамелеон, Столовая Гора
Орел: Геркулес, Змееносец, Змея, Щит, Стрелец, Козерог, Водолей, Малый Конь, Дельфин, Стрела
Орион: Единорог, Близнецы, Телец, Эридан, Заяц
Павлин: Октан, Индеец, Телескоп, Жертвенник, Райская Птица
Паруса: Насос, Компас, Корма, Киль, Кентавр
Пегас: Ящерица, Лебедь, Лисички, Дельфин, Малый Конь, Водолей, Рыбы, Андромеда
Персей: Кассиопея, Андромеда, Треугольник, Овен, Телец, Возничий, Жираф
Печь: Эридан, Кит, Скульптор, Феникс
Райская Птица: Жертвенник, Южный Треугольник, Циркуль, Муха, Хамелеон, Октан, Павлин
Рак: Лев, Малый Лев, Рысь, Близнецы, Малый Пес, Гидра
Резец: Часы, Золотая Рыба, Живописец, Голубь, Заяц, Эридан
Рыбы: Андромеда, Пегас, Водолей, Кит, Овен, Треугольник
Рысь: Жираф, Возничий, Близнецы, Рак, Лев, Малый Лев, Большая Медведица
Северная Корона: Геркулес, Волопас, Змея
Секстант: Гидра, Чаша, Лев
Сетка: Южная Гидра, Золотая Рыба, Часы
Скорпион: Жертвенник, Южная Корона, Стрелец, Змееносец, Весы, Волк, Наугольник
Скульптор: Кит, Водолей, Южная Рыба, Журавль, Феникс, Печь
Столовая Гора: Хамелеон, Летучая Рыба, Золотая Рыба, Южная Гидра, Октан
Стрела: Лисичка, Геркулес, Орел, Дельфин
Стрелец: Щит, Змея, Змееносец, Скорпион, Южная Корона, Телескоп, Индеец, Микроскоп, Козерог, Орел
Телескоп: Микроскоп, Стрелец, Южная Корона, Жертвенник, Павлин, Индеец
Телец: Близнецы, Возничий, Персей, Овен, Кит, Эридан, Орион
Треугольник: Рыбы, Овен, Персей, Андромеда
Тукан: Индеец, Октан, Южная Гидра, Эридан, Феникс, Журавль
Феникс: Печь, Скульптор, Журавль, Тукан, Южная Гидра, Эридан
Хамелеон: Октан, Райская Птица, Муха, Киль, Летучая Рыба, Столовая Гора
Цефей: Малая Медведица, Дракон, Лебедь, Ящерица, Кассиопея, Жираф
Циркуль: Волк, Кентавр, Муха, Райская Птица, Южный Треугольник, Наугольник
Часы: Эридан, Южная Гидра, Сетка, Золотая Рыба, Резец
Чаша: Ворон, Дева, Лев, Секстант, Гидра
Щит: Орел, Змея, Стрелец
Эридан: Заяц, Орион, Телец, Кит, Печь, Феникс, Тукан, Южная Гидра, Часы, Резец
Южная Гидра: Октан, Столовая Гора, Золотая Рыба, Сетка, Часы, Эридан, Феникс, Тукан
Южная Корона: Жертвенник, Телескоп, Стрелец, Скорпион
Южная Рыба: Водолей, Козерог, Микроскоп, Журавль, Скульптор
Южный Крест: Кентавр, Муха
Южный Треугольник: Жертвенник, Наугольник, Циркуль, Райская Птица
Ящерица: Цефей, Лебедь, Пегас, Андромеда, Кассиопея
